444444444
444444444
444444444
444444444
400444004
400444004
400444004
400444004
444444444
444444444
444000444
444000444
440000044
440000044
440444044
440444044
444444444
444444444
444444444
444444444