000111000
000111000
001111100
001111100
019019010
019019010
110010011
110010011
111111111
111111111
111111111
111111111
111111111
111111111
111111111
111111111
111111111
111111111
101101011
101101011