999999999
999999999
999999999
999999999
999999999
999999999
999999999
999999999
900999009
900999009
999999999
999999999
900000009
900000009
999999999
999999999