002242200
002242200
022444220
022444220
222242220
222242220
222222232
222222232
222222232
222222232
222222222
222222222
022222220
022222220
002222200
002222200