888888888
888888888
888888888
888888888
888888888
888888888
098888890
098888890
882222288
882222288
881222188
881222188
882222288
882222288
888888888
888888888