444466664
444466664
464666646
464666646
466666646
466666646
666666666
666666666
699666996
699666996
699666996
666555666
666555666
666555666
669999966
669999966
669999966
666666666
666666666