033333330
033333330
330333033
330333033
330333033
330333033
330333033
330333033
333333333
333333333
303333303
303333303
330000033
330000033
033333330
033333330